"filename", "language", "Java", "comment", "blank", "total"
"d:\AppData\VSCode\Projects\hizone\model\src\main\java\com\example\fenta\dao\PostReply.java", "Java", 13, 0, 11, 24
"d:\AppData\VSCode\Projects\hizone\model\src\main\java\com\example\fenta\dao\PostReplyComment.java", "Java", -13, 0, -11, -24
"d:\AppData\VSCode\Projects\hizone\model\src\main\java\com\example\fenta\front\interaction\UpdateCommentCount.java", "Java", 7, 0, 3, 10
"d:\AppData\VSCode\Projects\hizone\model\src\main\java\com\example\fenta\inter\UpdateReplyCount.java", "Java", 7, 0, 5, 12
"d:\AppData\VSCode\Projects\hizone\services\hizone-comment\src\main\java\com\example\controller\CommentController.java", "Java", 14, 19, 3, 36
"d:\AppData\VSCode\Projects\hizone\services\hizone-comment\src\main\java\com\example\mapper\CommentMapper.java", "Java", 3, 0, 1, 4
"d:\AppData\VSCode\Projects\hizone\services\hizone-comment\src\main\java\com\example\service\CacheService.java", "Java", 2, 0, 1, 3
"d:\AppData\VSCode\Projects\hizone\services\hizone-comment\src\main\java\com\example\service\CommentService.java", "Java", 2, 0, 2, 4
"d:\AppData\VSCode\Projects\hizone\services\hizone-comment\src\main\java\com\example\service\impl\CacheServiceImpl.java", "Java", 56, 1, 3, 60
"d:\AppData\VSCode\Projects\hizone\services\hizone-comment\src\main\java\com\example\service\impl\CommentServiceImpl.java", "Java", 5, 0, 1, 6
"d:\AppData\VSCode\Projects\hizone\services\hizone-interaction\src\main\java\com\example\controller\InteractionController.java", "Java", 8, 0, 1, 9
"Total", "-", 104, 20, 20, 144